#######################################
#<                                    #
#                                     #
#                                     #
#                                     #
#                                     #
#                                     #
#                                     #
#                                     #
#                                     #
#                                     #
################# ############### ### #
##########         ############## ### #
##########         ############## ### #
##########         ##             ### #
##########             ############   #
##########         #############    # #
##########         ###########   #### #
##########    >    ##########     ### #
##########         ####################
#######################################