###################################################################################################################
##########################################    #####################################################################
##########################################&   #####################################################################
##########################################    #####################################################################
##########################################    #####################################################################
##########################################    #####################################################################
##########################################    #####################################################################
###########################################+#######################################################################
########################################### #######################################################################
###########################################  ######################################################################
############################################    ###################################################################
############################################### ###################################################################
############################################### ###################################################################
############################################### ###################################################################
############################################### ###################################################################
####################################    ####### ###################################################################
################################     ##  ######  ##################################################################
#################                #######       # ########################              ############################
##############################################    #######################              ############################
##############################################  # #######################              ############################
#############################################     #######################              ##########                 #
############################################# #   #######################              ##########                 #
############################################# #  ########################              ##########                 #
###################################               #######################                ########                 #
###################################               #######################              #  #######                 #
###################################               #######################              ## #######                 #
###################################               #######################              ##  ######                 #
###################################               ########################## #############                        #
###################################               ########################## ######################################
###################################              ########################### ######################################
###################################              #########################   ######################################
###################################                 ###################### ########################################
###################################                 ###################### ########################################
###################################                 ###################### ########################################
###################################### ####         ###################### ########################################
######################################              ###################### ########################################
#####################################  ####         ###################### ########################################
##################################     ####         ##################          ###################################
#############################      ### ####         ##################          ###################################
############################  ########              ##################          ###################################
############################ #############               #############          ###################################
############################ ##############         ####  ############          ###################################
############################<##############                                     ###################################
###################################################################################################################