##########################################################################
###########################             ##################################
###########################             ##################################
###########################             ##################################
###########################             ##################################
###########################             ##################################
###########################             ##################################
##############  ###########             ##################################
##############        #####             ##################################
##############> #####                   ##################################
##############  ###########             ##################################
###########################             ##################################
###############################     ######################################
###############################   ########################################
###############################   ########################################
###############################   ########################################
###########################       ########################################
########################### ### ##########################################
##########################  #   ##########################################
########################## #  ##################             #############
########################## # ###################             #############
########################## # ###################             #############
########################## # ###################             #############
########################## # ###################             #############
########################## # ###################             #############
########################## #          ##########             #############
####<            #########            ##########             #############
####             ##########           #########              #############
####             ##########           ########               #############
####             ##########           ######## #             #############
####             ###########          ##       #             #############
####             ###########                                 #############
####             ###########          ##########             #############
####             ###########          ##########             #############
####             ###########          ############   #####################
####             ############         ############## #####################
####             #########              ############ #####################
####             ####      ##         #  ########### #####################
####              #   #######         ## ########### #####################
####                #########         ## ###########  ####################
####             # ##########         ## ############ ####################
####             #  ##################   ##########        ###############
#######*########### ##################*############        ###############
##########################################################################