#####################################################################################################
###########################  ########################################   #############################
###########################  ########################################   #############################
###########################  ########################################>  #############################
##########################         ##################################   #############################
##########################         ##################################   #############################
##########################         ##################################   #############################
#########################          ##################################   #############################
#########################          ##################################   #############################
######################### ###########################################   #############################
########################  ###########################################   #############################
######################## ############################################   #############################
########################        #####################################   #############################
######################## ######  ##################################### ##############################
######################## ####### ####################################  ##############################
######################## #######   ################################## ###############################
######################## ######### #################################  ###############################
######################## ######### ###############################   ################################
######################## ######### ############################### ##################################
######################## ######### ############################### ##################################
########################  ######## ############################### ##################################
######################### ######## ############################### ##################################
######################### ######## ###############################             ######################
######################### ######## ####   ########################             ######################
######################### ######## ####   ########################             ######################
######################### ######## ####   #######################              ######################
######################### ########        ################                     *#####################
######################### ########        ################                     ######################
#######################   #   ####        ################                     ######################
####################### ###   ####        ################                     ######################
######################  ###   ####        ################                     ######################
###################### ####   #       #   ################                     ######################
###################### ####     ##### #   ################                     ######################
###################### ####    ######     ################                           ################
###################### ####   ########    ##############                       #####          #######
###################### ####   ########     #########     #                     ############## #######
###################### ###############     #######   ##############            ############## #######
###################### ###############             ################            ##############       #
#####################  ############### ####  ####################################################   #
###################   ################ #####  ###################################################   #
##############<     ################## ###### ###################################################   #
###################################### ###### ###################################################   #
###################################### ###### ###################################################   #
#####################################################################################################